7777777777777777777777777777777777777777
2282222222222222222222222222222222222222
2511121111111222111111111112211221122112
2222111222221111112222211211111111111112
2111111111111222211111111211221111221112
2111111111111111112112211211111111111212
2211222211122221112111111111112122191212
2111111111111111112111222222212111121212
2112222222211122111111111111111122121112
2211111111111111111221122211111111111112
2211121122112111121111111111111211222222
2211121111112141121122211121111211111112
2112121111112111121111111121111211112222
2112111122211111111112222111111211211112
2112121111112221211111111122211111211122
2111111111111111212221111111112211211122
2112112112112111111111212221111111111122
2112112112112112112121111111111222211112
2112112112112112112121112122211111112112
2112112112112112112121112111111121212112
2111112111112112112121112121222121212112
2221111111111111111111111121111121211112
2111121121112222112222221111222111112112
2111011111111111111111111111111112211112
2222222222222222222222222222222222222222
